R 1200 800

NO ./textures/wall_0.xpm
SO ./textures/wall_1.xpm
WE ./textures/wall_2.xpm
EA ./textures/wall_3.xpm
S ./textures/barrel.xpm

F 220,100,0
C 225,30,0

111111111111111
100000000000001
100000000000001
1000000000S0001
100000000000001
100000000000001
100000000000001
100000000000001
100000000000001
100000000000001
100000002000001
100000200000001
100000000000001
100000000000001
100000000002001
100000000000001
100000000000001
100000000000001
100000000000001
100000000000001
111111111111111