R 1500 900

NO ./textures/wall_0.xpm
SO ./textures/wall_1.xpm
WE ./textures/wall_2.xpm
EA ./textures/wall_3.xpm
S ./textures/barrel.xpm

F 220,100,0
C 225,30,0

111111111111
1000000000001
1000000000001
1000000000001
1000000000001
1000002000001
1000000000001
1000000000001
1111111100001
1000020000001
10000000N0001
1000000000001
1000000000001
1000000020001
1002000000001
1110000020001
  11100001111
  11100001111
  11100001111
  11100001111111111
  11100000000000001
  11100000000000001
  11111111111111111