R 1600 900

NO ./textures/wall_0.xpm
SO ./textures/wall_1.xpm
WE ./textures/wall_2.xpm
EA ./textures/wall_3.xpm
S ./textures/barrel.xpm

F 220,150,0
C 225,30,0

111111111111
1000000000001
1000000000001
1000011100001
1000000000001
1000002000001
1000000000001
1011111100001
1000200000001
1000000000001
10000000N0001
1000000000001
1002000020001
1000000000001
1110000000001
1111111111111